##########
#   ☺    #
#  ■ ○   #
#        #
#   ######
#   #    #
#   # ■  #
#   # ○  #
#        #
##########
