##########
#   ■    #
# ☺ ○    #
#        #
#   ######
#   #    #
#   # ■  #
#   # ○  #
#        #
##########
