##########
#☺   ■   #
#    ○   #
#        #
#   ######
#   #    #
#   # ○  #
#   # ■  #
#        #
##########
