##########
#   ■    #
#   ○    #
#   ☺    #
#   ######
#   #    #
#   # ■  #
#   # ○  #
#        #
##########
