##########
#☺       #
#  ■     #
#  ○     #
#        #
#     ■  #
#     ○  #
#        #
#        #
##########
